########I   #########################################################
#########   ##########################                    ###########
#########      ###############          #############################
############   ###############   ###########################      ###
############   ###############   ######################        ######
######                                                    ###########
######  #####################################   #####################
##      #####################################   #####################
######  ############                                       ##########
######  ############   ######################  ##########         ###
######       ##        ######################  ##########  #####  ###
######  ############   ######################  ##########  #####  ###
######  ############                 ########  ##########  #####  ###
######  ###########################  ########  ###############    ###
######           ##################  ########          ##############
###############  ##########          ################         #######
###############  ##########   ##############################  #######
###############  ##########   ##############################  #######
###              ##########                        ######        ####
###  ###########################################   ##################
###                                       ######   ##################
########################################  ######   ##################
####                           #########  ######   ##################
##########################                ######              #######
######################################################   ############
######################################################S  ############
